Loading apps models...
[DEBUG] signals.py is loaded
/	apps.views.login_view	app:login
/TermsofService/	apps.views.TermsofService	app:TermsofService
/__debug__/history_refresh/	debug_toolbar.panels.history.views.history_refresh	djdt:history_refresh
/__debug__/history_sidebar/	debug_toolbar.panels.history.views.history_sidebar	djdt:history_sidebar
/__debug__/render_panel/	debug_toolbar.views.render_panel	djdt:render_panel
/__debug__/sql_explain/	debug_toolbar.panels.sql.views.sql_explain	djdt:sql_explain
/__debug__/sql_profile/	debug_toolbar.panels.sql.views.sql_profile	djdt:sql_profile
/__debug__/sql_select/	debug_toolbar.panels.sql.views.sql_select	djdt:sql_select
/__debug__/template_source/	debug_toolbar.panels.templates.views.template_source	djdt:template_source
/accounts/3rdparty/	allauth.socialaccount.views.ConnectionsView	socialaccount_connections
/accounts/3rdparty/login/cancelled/	allauth.socialaccount.views.LoginCancelledView	socialaccount_login_cancelled
/accounts/3rdparty/login/error/	allauth.socialaccount.views.LoginErrorView	socialaccount_login_error
/accounts/3rdparty/signup/	allauth.socialaccount.views.SignupView	socialaccount_signup
/accounts/confirm-email/	allauth.account.views.EmailVerificationSentView	account_email_verification_sent
/accounts/confirm-email/<key>/	allauth.account.views.ConfirmEmailView	account_confirm_email
/accounts/email/	allauth.account.views.EmailView	account_email
/accounts/inactive/	allauth.account.views.AccountInactiveView	account_inactive
/accounts/login/	allauth.account.views.LoginView	account_login
/accounts/logout/	allauth.account.views.LogoutView	account_logout
/accounts/password/change/	allauth.account.views.PasswordChangeView	account_change_password
/accounts/password/reset/	allauth.account.views.PasswordResetView	account_reset_password
/accounts/password/reset/done/	allauth.account.views.PasswordResetDoneView	account_reset_password_done
/accounts/password/reset/key/<uidb36>-<key>/	allauth.account.views.PasswordResetFromKeyView	account_reset_password_from_key
/accounts/password/reset/key/done/	allauth.account.views.PasswordResetFromKeyDoneView	account_reset_password_from_key_done
/accounts/password/set/	allauth.account.views.PasswordSetView	account_set_password
/accounts/reauthenticate/	allauth.account.views.ReauthenticateView	account_reauthenticate
/accounts/signup/	allauth.account.views.SignupView	account_signup
/accounts/social/connections/	django.views.generic.base.RedirectView
/accounts/social/login/cancelled/	django.views.generic.base.RedirectView
/accounts/social/login/error/	django.views.generic.base.RedirectView
/accounts/social/signup/	django.views.generic.base.RedirectView
/action-log/	apps.log_views.action_log_view	action_log
/add_appointment/	apps.views.add_appointment_form	app:add_appointment
/add_group/	apps.views.add_group	app:add_group
/add_prescription/	apps.views.add_prescription_form	app:add_prescription
/admin/	django.contrib.admin.sites.index	admin:index
/admin/<app_label>/	django.contrib.admin.sites.app_index	admin:app_list
/admin/<url>	django.contrib.admin.sites.catch_all_view
/admin/account/emailaddress/	django.contrib.admin.options.changelist_view	admin:account_emailaddress_changelist
/admin/account/emailaddress/<path:object_id>/	django.views.generic.base.RedirectView
/admin/account/emailaddress/<path:object_id>/change/	django.contrib.admin.options.change_view	admin:account_emailaddress_change
/admin/account/emailaddress/<path:object_id>/delete/	django.contrib.admin.options.delete_view	admin:account_emailaddress_delete
/admin/account/emailaddress/<path:object_id>/history/	django.contrib.admin.options.history_view	admin:account_emailaddress_history
/admin/account/emailaddress/add/	django.contrib.admin.options.add_view	admin:account_emailaddress_add
/admin/actstream/action/	django.contrib.admin.options.changelist_view	admin:actstream_action_changelist
/admin/actstream/action/<path:object_id>/	django.views.generic.base.RedirectView
/admin/actstream/action/<path:object_id>/change/	django.contrib.admin.options.change_view	admin:actstream_action_change
/admin/actstream/action/<path:object_id>/delete/	django.contrib.admin.options.delete_view	admin:actstream_action_delete
/admin/actstream/action/<path:object_id>/history/	django.contrib.admin.options.history_view	admin:actstream_action_history
/admin/actstream/action/add/	django.contrib.admin.options.add_view	admin:actstream_action_add
/admin/actstream/follow/	django.contrib.admin.options.changelist_view	admin:actstream_follow_changelist
/admin/actstream/follow/<path:object_id>/	django.views.generic.base.RedirectView
/admin/actstream/follow/<path:object_id>/change/	django.contrib.admin.options.change_view	admin:actstream_follow_change
/admin/actstream/follow/<path:object_id>/delete/	django.contrib.admin.options.delete_view	admin:actstream_follow_delete
/admin/actstream/follow/<path:object_id>/history/	django.contrib.admin.options.history_view	admin:actstream_follow_history
/admin/actstream/follow/add/	django.contrib.admin.options.add_view	admin:actstream_follow_add
/admin/apps/accommodation/	import_export.admin.changelist_view	admin:apps_accommodation_changelist
/admin/apps/accommodation/<path:object_id>/	django.views.generic.base.RedirectView
/admin/apps/accommodation/<path:object_id>/change/	django.contrib.admin.options.change_view	admin:apps_accommodation_change
/admin/apps/accommodation/<path:object_id>/delete/	django.contrib.admin.options.delete_view	admin:apps_accommodation_delete
/admin/apps/accommodation/<path:object_id>/history/	django.contrib.admin.options.history_view	admin:apps_accommodation_history
/admin/apps/accommodation/add/	django.contrib.admin.options.add_view	admin:apps_accommodation_add
/admin/apps/accommodation/export/	import_export.admin.export_action	admin:apps_accommodation_export
/admin/apps/accommodation/import/	import_export.admin.import_action	admin:apps_accommodation_import
/admin/apps/accommodation/process_import/	import_export.admin.process_import	admin:apps_accommodation_process_import
/admin/apps/appointment/	import_export.admin.changelist_view	admin:apps_appointment_changelist
/admin/apps/appointment/<path:object_id>/	django.views.generic.base.RedirectView
/admin/apps/appointment/<path:object_id>/change/	django.contrib.admin.options.change_view	admin:apps_appointment_change
/admin/apps/appointment/<path:object_id>/delete/	django.contrib.admin.options.delete_view	admin:apps_appointment_delete
/admin/apps/appointment/<path:object_id>/history/	django.contrib.admin.options.history_view	admin:apps_appointment_history
/admin/apps/appointment/add/	django.contrib.admin.options.add_view	admin:apps_appointment_add
/admin/apps/appointment/export/	import_export.admin.export_action	admin:apps_appointment_export
/admin/apps/appointment/import/	import_export.admin.import_action	admin:apps_appointment_import
/admin/apps/appointment/process_import/	import_export.admin.process_import	admin:apps_appointment_process_import
/admin/apps/contact/	import_export.admin.changelist_view	admin:apps_contact_changelist
/admin/apps/contact/<path:object_id>/	django.views.generic.base.RedirectView
/admin/apps/contact/<path:object_id>/change/	django.contrib.admin.options.change_view	admin:apps_contact_change
/admin/apps/contact/<path:object_id>/delete/	django.contrib.admin.options.delete_view	admin:apps_contact_delete
/admin/apps/contact/<path:object_id>/history/	django.contrib.admin.options.history_view	admin:apps_contact_history
/admin/apps/contact/add/	django.contrib.admin.options.add_view	admin:apps_contact_add
/admin/apps/contact/export/	import_export.admin.export_action	admin:apps_contact_export
/admin/apps/contact/import/	import_export.admin.import_action	admin:apps_contact_import
/admin/apps/contact/process_import/	import_export.admin.process_import	admin:apps_contact_process_import
/admin/apps/emailtemplate/	import_export.admin.changelist_view	admin:apps_emailtemplate_changelist
/admin/apps/emailtemplate/<path:object_id>/	django.views.generic.base.RedirectView
/admin/apps/emailtemplate/<path:object_id>/change/	django.contrib.admin.options.change_view	admin:apps_emailtemplate_change
/admin/apps/emailtemplate/<path:object_id>/delete/	django.contrib.admin.options.delete_view	admin:apps_emailtemplate_delete
/admin/apps/emailtemplate/<path:object_id>/history/	django.contrib.admin.options.history_view	admin:apps_emailtemplate_history
/admin/apps/emailtemplate/add/	django.contrib.admin.options.add_view	admin:apps_emailtemplate_add
/admin/apps/emailtemplate/export/	import_export.admin.export_action	admin:apps_emailtemplate_export
/admin/apps/emailtemplate/import/	import_export.admin.import_action	admin:apps_emailtemplate_import
/admin/apps/emailtemplate/process_import/	import_export.admin.process_import	admin:apps_emailtemplate_process_import
/admin/apps/emergencycontact/	import_export.admin.changelist_view	admin:apps_emergencycontact_changelist
/admin/apps/emergencycontact/<path:object_id>/	django.views.generic.base.RedirectView
/admin/apps/emergencycontact/<path:object_id>/change/	django.contrib.admin.options.change_view	admin:apps_emergencycontact_change
/admin/apps/emergencycontact/<path:object_id>/delete/	django.contrib.admin.options.delete_view	admin:apps_emergencycontact_delete
/admin/apps/emergencycontact/<path:object_id>/history/	django.contrib.admin.options.history_view	admin:apps_emergencycontact_history
/admin/apps/emergencycontact/add/	django.contrib.admin.options.add_view	admin:apps_emergencycontact_add
/admin/apps/emergencycontact/export/	import_export.admin.export_action	admin:apps_emergencycontact_export
/admin/apps/emergencycontact/import/	import_export.admin.import_action	admin:apps_emergencycontact_import
/admin/apps/emergencycontact/process_import/	import_export.admin.process_import	admin:apps_emergencycontact_process_import
/admin/apps/flightreservation/	import_export.admin.changelist_view	admin:apps_flightreservation_changelist
/admin/apps/flightreservation/<path:object_id>/	django.views.generic.base.RedirectView
/admin/apps/flightreservation/<path:object_id>/change/	django.contrib.admin.options.change_view	admin:apps_flightreservation_change
/admin/apps/flightreservation/<path:object_id>/delete/	django.contrib.admin.options.delete_view	admin:apps_flightreservation_delete
/admin/apps/flightreservation/<path:object_id>/history/	django.contrib.admin.options.history_view	admin:apps_flightreservation_history
/admin/apps/flightreservation/add/	django.contrib.admin.options.add_view	admin:apps_flightreservation_add
/admin/apps/flightreservation/export/	import_export.admin.export_action	admin:apps_flightreservation_export
/admin/apps/flightreservation/import/	import_export.admin.import_action	admin:apps_flightreservation_import
/admin/apps/flightreservation/process_import/	import_export.admin.process_import	admin:apps_flightreservation_process_import
/admin/apps/hospital/	import_export.admin.changelist_view	admin:apps_hospital_changelist
/admin/apps/hospital/<path:object_id>/	django.views.generic.base.RedirectView
/admin/apps/hospital/<path:object_id>/change/	django.contrib.admin.options.change_view	admin:apps_hospital_change
/admin/apps/hospital/<path:object_id>/delete/	django.contrib.admin.options.delete_view	admin:apps_hospital_delete
/admin/apps/hospital/<path:object_id>/history/	django.contrib.admin.options.history_view	admin:apps_hospital_history
/admin/apps/hospital/add/	django.contrib.admin.options.add_view	admin:apps_hospital_add
/admin/apps/hospital/export/	import_export.admin.export_action	admin:apps_hospital_export
/admin/apps/hospital/import/	import_export.admin.import_action	admin:apps_hospital_import
/admin/apps/hospital/process_import/	import_export.admin.process_import	admin:apps_hospital_process_import
/admin/apps/hospitalstay/	import_export.admin.changelist_view	admin:apps_hospitalstay_changelist
/admin/apps/hospitalstay/<path:object_id>/	django.views.generic.base.RedirectView
/admin/apps/hospitalstay/<path:object_id>/change/	django.contrib.admin.options.change_view	admin:apps_hospitalstay_change
/admin/apps/hospitalstay/<path:object_id>/delete/	django.contrib.admin.options.delete_view	admin:apps_hospitalstay_delete
/admin/apps/hospitalstay/<path:object_id>/history/	django.contrib.admin.options.history_view	admin:apps_hospitalstay_history
/admin/apps/hospitalstay/add/	django.contrib.admin.options.add_view	admin:apps_hospitalstay_add
/admin/apps/hospitalstay/export/	import_export.admin.export_action	admin:apps_hospitalstay_export
/admin/apps/hospitalstay/import/	import_export.admin.import_action	admin:apps_hospitalstay_import
/admin/apps/hospitalstay/process_import/	import_export.admin.process_import	admin:apps_hospitalstay_process_import
/admin/apps/hotel/	import_export.admin.changelist_view	admin:apps_hotel_changelist
/admin/apps/hotel/<path:object_id>/	django.views.generic.base.RedirectView
/admin/apps/hotel/<path:object_id>/change/	django.contrib.admin.options.change_view	admin:apps_hotel_change
/admin/apps/hotel/<path:object_id>/delete/	django.contrib.admin.options.delete_view	admin:apps_hotel_delete
/admin/apps/hotel/<path:object_id>/history/	django.contrib.admin.options.history_view	admin:apps_hotel_history
/admin/apps/hotel/add/	django.contrib.admin.options.add_view	admin:apps_hotel_add
/admin/apps/hotel/export/	import_export.admin.export_action	admin:apps_hotel_export
/admin/apps/hotel/import/	import_export.admin.import_action	admin:apps_hotel_import
/admin/apps/hotel/process_import/	import_export.admin.process_import	admin:apps_hotel_process_import
/admin/apps/insurance/	import_export.admin.changelist_view	admin:apps_insurance_changelist
/admin/apps/insurance/<path:object_id>/	django.views.generic.base.RedirectView
/admin/apps/insurance/<path:object_id>/change/	django.contrib.admin.options.change_view	admin:apps_insurance_change
/admin/apps/insurance/<path:object_id>/delete/	django.contrib.admin.options.delete_view	admin:apps_insurance_delete
/admin/apps/insurance/<path:object_id>/history/	django.contrib.admin.options.history_view	admin:apps_insurance_history
/admin/apps/insurance/add/	django.contrib.admin.options.add_view	admin:apps_insurance_add
/admin/apps/insurance/export/	import_export.admin.export_action	admin:apps_insurance_export
/admin/apps/insurance/import/	import_export.admin.import_action	admin:apps_insurance_import
/admin/apps/insurance/process_import/	import_export.admin.process_import	admin:apps_insurance_process_import
/admin/apps/medicalinformation/	import_export.admin.changelist_view	admin:apps_medicalinformation_changelist
/admin/apps/medicalinformation/<path:object_id>/	django.views.generic.base.RedirectView
/admin/apps/medicalinformation/<path:object_id>/change/	django.contrib.admin.options.change_view	admin:apps_medicalinformation_change
/admin/apps/medicalinformation/<path:object_id>/delete/	django.contrib.admin.options.delete_view	admin:apps_medicalinformation_delete
/admin/apps/medicalinformation/<path:object_id>/history/	django.contrib.admin.options.history_view	admin:apps_medicalinformation_history
/admin/apps/medicalinformation/add/	django.contrib.admin.options.add_view	admin:apps_medicalinformation_add
/admin/apps/medicalinformation/export/	import_export.admin.export_action	admin:apps_medicalinformation_export
/admin/apps/medicalinformation/import/	import_export.admin.import_action	admin:apps_medicalinformation_import
/admin/apps/medicalinformation/process_import/	import_export.admin.process_import	admin:apps_medicalinformation_process_import
/admin/apps/message/	import_export.admin.changelist_view	admin:apps_message_changelist
/admin/apps/message/<path:object_id>/	django.views.generic.base.RedirectView
/admin/apps/message/<path:object_id>/change/	django.contrib.admin.options.change_view	admin:apps_message_change
/admin/apps/message/<path:object_id>/delete/	django.contrib.admin.options.delete_view	admin:apps_message_delete
/admin/apps/message/<path:object_id>/history/	django.contrib.admin.options.history_view	admin:apps_message_history
/admin/apps/message/add/	django.contrib.admin.options.add_view	admin:apps_message_add
/admin/apps/message/export/	import_export.admin.export_action	admin:apps_message_export
/admin/apps/message/import/	import_export.admin.import_action	admin:apps_message_import
/admin/apps/message/process_import/	import_export.admin.process_import	admin:apps_message_process_import
/admin/apps/messagegroup/	import_export.admin.changelist_view	admin:apps_messagegroup_changelist
/admin/apps/messagegroup/<path:object_id>/	django.views.generic.base.RedirectView
/admin/apps/messagegroup/<path:object_id>/change/	django.contrib.admin.options.change_view	admin:apps_messagegroup_change
/admin/apps/messagegroup/<path:object_id>/delete/	django.contrib.admin.options.delete_view	admin:apps_messagegroup_delete
/admin/apps/messagegroup/<path:object_id>/history/	django.contrib.admin.options.history_view	admin:apps_messagegroup_history
/admin/apps/messagegroup/add/	django.contrib.admin.options.add_view	admin:apps_messagegroup_add
/admin/apps/messagegroup/export/	import_export.admin.export_action	admin:apps_messagegroup_export
/admin/apps/messagegroup/import/	import_export.admin.import_action	admin:apps_messagegroup_import
/admin/apps/messagegroup/process_import/	import_export.admin.process_import	admin:apps_messagegroup_process_import
/admin/apps/patientschedule/	import_export.admin.changelist_view	admin:apps_patientschedule_changelist
/admin/apps/patientschedule/<path:object_id>/	django.views.generic.base.RedirectView
/admin/apps/patientschedule/<path:object_id>/change/	django.contrib.admin.options.change_view	admin:apps_patientschedule_change
/admin/apps/patientschedule/<path:object_id>/delete/	django.contrib.admin.options.delete_view	admin:apps_patientschedule_delete
/admin/apps/patientschedule/<path:object_id>/history/	django.contrib.admin.options.history_view	admin:apps_patientschedule_history
/admin/apps/patientschedule/add/	django.contrib.admin.options.add_view	admin:apps_patientschedule_add
/admin/apps/patientschedule/export/	import_export.admin.export_action	admin:apps_patientschedule_export
/admin/apps/patientschedule/import/	import_export.admin.import_action	admin:apps_patientschedule_import
/admin/apps/patientschedule/process_import/	import_export.admin.process_import	admin:apps_patientschedule_process_import
/admin/apps/prescription/	import_export.admin.changelist_view	admin:apps_prescription_changelist
/admin/apps/prescription/<path:object_id>/	django.views.generic.base.RedirectView
/admin/apps/prescription/<path:object_id>/change/	django.contrib.admin.options.change_view	admin:apps_prescription_change
/admin/apps/prescription/<path:object_id>/delete/	django.contrib.admin.options.delete_view	admin:apps_prescription_delete
/admin/apps/prescription/<path:object_id>/history/	django.contrib.admin.options.history_view	admin:apps_prescription_history
/admin/apps/prescription/add/	django.contrib.admin.options.add_view	admin:apps_prescription_add
/admin/apps/prescription/export/	import_export.admin.export_action	admin:apps_prescription_export
/admin/apps/prescription/import/	import_export.admin.import_action	admin:apps_prescription_import
/admin/apps/prescription/process_import/	import_export.admin.process_import	admin:apps_prescription_process_import
/admin/apps/referral/	import_export.admin.changelist_view	admin:apps_referral_changelist
/admin/apps/referral/<path:object_id>/	django.views.generic.base.RedirectView
/admin/apps/referral/<path:object_id>/change/	django.contrib.admin.options.change_view	admin:apps_referral_change
/admin/apps/referral/<path:object_id>/delete/	django.contrib.admin.options.delete_view	admin:apps_referral_delete
/admin/apps/referral/<path:object_id>/history/	django.contrib.admin.options.history_view	admin:apps_referral_history
/admin/apps/referral/add/	django.contrib.admin.options.add_view	admin:apps_referral_add
/admin/apps/referral/export/	import_export.admin.export_action	admin:apps_referral_export
/admin/apps/referral/import/	import_export.admin.import_action	admin:apps_referral_import
/admin/apps/referral/process_import/	import_export.admin.process_import	admin:apps_referral_process_import
/admin/apps/subscription/	import_export.admin.changelist_view	admin:apps_subscription_changelist
/admin/apps/subscription/<path:object_id>/	django.views.generic.base.RedirectView
/admin/apps/subscription/<path:object_id>/change/	django.contrib.admin.options.change_view	admin:apps_subscription_change
/admin/apps/subscription/<path:object_id>/delete/	django.contrib.admin.options.delete_view	admin:apps_subscription_delete
/admin/apps/subscription/<path:object_id>/history/	django.contrib.admin.options.history_view	admin:apps_subscription_history
/admin/apps/subscription/add/	django.contrib.admin.options.add_view	admin:apps_subscription_add
/admin/apps/subscription/export/	import_export.admin.export_action	admin:apps_subscription_export
/admin/apps/subscription/import/	import_export.admin.import_action	admin:apps_subscription_import
/admin/apps/subscription/process_import/	import_export.admin.process_import	admin:apps_subscription_process_import
/admin/apps/treatmentplan/	import_export.admin.changelist_view	admin:apps_treatmentplan_changelist
/admin/apps/treatmentplan/<path:object_id>/	django.views.generic.base.RedirectView
/admin/apps/treatmentplan/<path:object_id>/change/	django.contrib.admin.options.change_view	admin:apps_treatmentplan_change
/admin/apps/treatmentplan/<path:object_id>/delete/	django.contrib.admin.options.delete_view	admin:apps_treatmentplan_delete
/admin/apps/treatmentplan/<path:object_id>/history/	django.contrib.admin.options.history_view	admin:apps_treatmentplan_history
/admin/apps/treatmentplan/add/	django.contrib.admin.options.add_view	admin:apps_treatmentplan_add
/admin/apps/treatmentplan/export/	import_export.admin.export_action	admin:apps_treatmentplan_export
/admin/apps/treatmentplan/import/	import_export.admin.import_action	admin:apps_treatmentplan_import
/admin/apps/treatmentplan/process_import/	import_export.admin.process_import	admin:apps_treatmentplan_process_import
/admin/apps/treatmentplanitem/	import_export.admin.changelist_view	admin:apps_treatmentplanitem_changelist
/admin/apps/treatmentplanitem/<path:object_id>/	django.views.generic.base.RedirectView
/admin/apps/treatmentplanitem/<path:object_id>/change/	django.contrib.admin.options.change_view	admin:apps_treatmentplanitem_change
/admin/apps/treatmentplanitem/<path:object_id>/delete/	django.contrib.admin.options.delete_view	admin:apps_treatmentplanitem_delete
/admin/apps/treatmentplanitem/<path:object_id>/history/	django.contrib.admin.options.history_view	admin:apps_treatmentplanitem_history
/admin/apps/treatmentplanitem/add/	django.contrib.admin.options.add_view	admin:apps_treatmentplanitem_add
/admin/apps/treatmentplanitem/export/	import_export.admin.export_action	admin:apps_treatmentplanitem_export
/admin/apps/treatmentplanitem/import/	import_export.admin.import_action	admin:apps_treatmentplanitem_import
/admin/apps/treatmentplanitem/process_import/	import_export.admin.process_import	admin:apps_treatmentplanitem_process_import
/admin/apps/treatmentproduct/	import_export.admin.changelist_view	admin:apps_treatmentproduct_changelist
/admin/apps/treatmentproduct/<path:object_id>/	django.views.generic.base.RedirectView
/admin/apps/treatmentproduct/<path:object_id>/change/	django.contrib.admin.options.change_view	admin:apps_treatmentproduct_change
/admin/apps/treatmentproduct/<path:object_id>/delete/	django.contrib.admin.options.delete_view	admin:apps_treatmentproduct_delete
/admin/apps/treatmentproduct/<path:object_id>/history/	django.contrib.admin.options.history_view	admin:apps_treatmentproduct_history
/admin/apps/treatmentproduct/add/	django.contrib.admin.options.add_view	admin:apps_treatmentproduct_add
/admin/apps/treatmentproduct/export/	import_export.admin.export_action	admin:apps_treatmentproduct_export
/admin/apps/treatmentproduct/import/	import_export.admin.import_action	admin:apps_treatmentproduct_import
/admin/apps/treatmentproduct/process_import/	import_export.admin.process_import	admin:apps_treatmentproduct_process_import
/admin/apps/user/	import_export.admin.changelist_view	admin:apps_user_changelist
/admin/apps/user/<path:object_id>/	django.views.generic.base.RedirectView
/admin/apps/user/<path:object_id>/change/	django.contrib.admin.options.change_view	admin:apps_user_change
/admin/apps/user/<path:object_id>/delete/	django.contrib.admin.options.delete_view	admin:apps_user_delete
/admin/apps/user/<path:object_id>/history/	django.contrib.admin.options.history_view	admin:apps_user_history
/admin/apps/user/add/	django.contrib.admin.options.add_view	admin:apps_user_add
/admin/apps/user/export/	import_export.admin.export_action	admin:apps_user_export
/admin/apps/user/import/	import_export.admin.import_action	admin:apps_user_import
/admin/apps/user/process_import/	import_export.admin.process_import	admin:apps_user_process_import
/admin/auth/group/	django.contrib.admin.options.changelist_view	admin:auth_group_changelist
/admin/auth/group/<path:object_id>/	django.views.generic.base.RedirectView
/admin/auth/group/<path:object_id>/change/	django.contrib.admin.options.change_view	admin:auth_group_change
/admin/auth/group/<path:object_id>/delete/	django.contrib.admin.options.delete_view	admin:auth_group_delete
/admin/auth/group/<path:object_id>/history/	django.contrib.admin.options.history_view	admin:auth_group_history
/admin/auth/group/add/	django.contrib.admin.options.add_view	admin:auth_group_add
/admin/authtoken/tokenproxy/	django.contrib.admin.options.changelist_view	admin:authtoken_tokenproxy_changelist
/admin/authtoken/tokenproxy/<path:object_id>/	django.views.generic.base.RedirectView
/admin/authtoken/tokenproxy/<path:object_id>/change/	django.contrib.admin.options.change_view	admin:authtoken_tokenproxy_change
/admin/authtoken/tokenproxy/<path:object_id>/delete/	django.contrib.admin.options.delete_view	admin:authtoken_tokenproxy_delete
/admin/authtoken/tokenproxy/<path:object_id>/history/	django.contrib.admin.options.history_view	admin:authtoken_tokenproxy_history
/admin/authtoken/tokenproxy/add/	django.contrib.admin.options.add_view	admin:authtoken_tokenproxy_add
/admin/autocomplete/	django.contrib.admin.sites.autocomplete_view	admin:autocomplete
/admin/baton/batontheme/	django.contrib.admin.options.changelist_view	admin:baton_batontheme_changelist
/admin/baton/batontheme/<path:object_id>/	django.views.generic.base.RedirectView
/admin/baton/batontheme/<path:object_id>/change/	django.contrib.admin.options.change_view	admin:baton_batontheme_change
/admin/baton/batontheme/<path:object_id>/delete/	django.contrib.admin.options.delete_view	admin:baton_batontheme_delete
/admin/baton/batontheme/<path:object_id>/history/	django.contrib.admin.options.history_view	admin:baton_batontheme_history
/admin/baton/batontheme/add/	django.contrib.admin.options.add_view	admin:baton_batontheme_add
/admin/doc/	django.contrib.admindocs.views.BaseAdminDocsView	django-admindocs-docroot
/admin/doc/bookmarklets/	django.contrib.admindocs.views.BookmarkletsView	django-admindocs-bookmarklets
/admin/doc/filters/	django.contrib.admindocs.views.TemplateFilterIndexView	django-admindocs-filters
/admin/doc/models/	django.contrib.admindocs.views.ModelIndexView	django-admindocs-models-index
/admin/doc/models/<app_label>\.<model_name>/	django.contrib.admindocs.views.ModelDetailView	django-admindocs-models-detail
/admin/doc/tags/	django.contrib.admindocs.views.TemplateTagIndexView	django-admindocs-tags
/admin/doc/templates/<path:template>/	django.contrib.admindocs.views.TemplateDetailView	django-admindocs-templates
/admin/doc/views/	django.contrib.admindocs.views.ViewIndexView	django-admindocs-views-index
/admin/doc/views/<view>/	django.contrib.admindocs.views.ViewDetailView	django-admindocs-views-detail
/admin/jsi18n/	django.contrib.admin.sites.i18n_javascript	admin:jsi18n
/admin/leads/lead/	import_export.admin.changelist_view	admin:leads_lead_changelist
/admin/leads/lead/<path:object_id>/	django.views.generic.base.RedirectView
/admin/leads/lead/<path:object_id>/change/	django.contrib.admin.options.change_view	admin:leads_lead_change
/admin/leads/lead/<path:object_id>/delete/	django.contrib.admin.options.delete_view	admin:leads_lead_delete
/admin/leads/lead/<path:object_id>/history/	django.contrib.admin.options.history_view	admin:leads_lead_history
/admin/leads/lead/add/	django.contrib.admin.options.add_view	admin:leads_lead_add
/admin/leads/lead/export/	import_export.admin.export_action	admin:leads_lead_export
/admin/leads/lead/import/	import_export.admin.import_action	admin:leads_lead_import
/admin/leads/lead/process_import/	import_export.admin.process_import	admin:leads_lead_process_import
/admin/leads/leadhistory/	import_export.admin.changelist_view	admin:leads_leadhistory_changelist
/admin/leads/leadhistory/<path:object_id>/	django.views.generic.base.RedirectView
/admin/leads/leadhistory/<path:object_id>/change/	django.contrib.admin.options.change_view	admin:leads_leadhistory_change
/admin/leads/leadhistory/<path:object_id>/delete/	django.contrib.admin.options.delete_view	admin:leads_leadhistory_delete
/admin/leads/leadhistory/<path:object_id>/history/	django.contrib.admin.options.history_view	admin:leads_leadhistory_history
/admin/leads/leadhistory/add/	django.contrib.admin.options.add_view	admin:leads_leadhistory_add
/admin/leads/leadhistory/export/	import_export.admin.export_action	admin:leads_leadhistory_export
/admin/leads/leadhistory/import/	import_export.admin.import_action	admin:leads_leadhistory_import
/admin/leads/leadhistory/process_import/	import_export.admin.process_import	admin:leads_leadhistory_process_import
/admin/leads/note/	import_export.admin.changelist_view	admin:leads_note_changelist
/admin/leads/note/<path:object_id>/	django.views.generic.base.RedirectView
/admin/leads/note/<path:object_id>/change/	django.contrib.admin.options.change_view	admin:leads_note_change
/admin/leads/note/<path:object_id>/delete/	django.contrib.admin.options.delete_view	admin:leads_note_delete
/admin/leads/note/<path:object_id>/history/	django.contrib.admin.options.history_view	admin:leads_note_history
/admin/leads/note/add/	django.contrib.admin.options.add_view	admin:leads_note_add
/admin/leads/note/export/	import_export.admin.export_action	admin:leads_note_export
/admin/leads/note/import/	import_export.admin.import_action	admin:leads_note_import
/admin/leads/note/process_import/	import_export.admin.process_import	admin:leads_note_process_import
/admin/login/	django.contrib.admin.sites.login	admin:login
/admin/logout/	django.contrib.admin.sites.logout	admin:logout
/admin/password_change/	django.contrib.admin.sites.password_change	admin:password_change
/admin/password_change/done/	django.contrib.admin.sites.password_change_done	admin:password_change_done
/admin/r/<int:content_type_id>/<path:object_id>/	django.contrib.contenttypes.views.shortcut	admin:view_on_site
/admin/sites/site/	django.contrib.admin.options.changelist_view	admin:sites_site_changelist
/admin/sites/site/<path:object_id>/	django.views.generic.base.RedirectView
/admin/sites/site/<path:object_id>/change/	django.contrib.admin.options.change_view	admin:sites_site_change
/admin/sites/site/<path:object_id>/delete/	django.contrib.admin.options.delete_view	admin:sites_site_delete
/admin/sites/site/<path:object_id>/history/	django.contrib.admin.options.history_view	admin:sites_site_history
/admin/sites/site/add/	django.contrib.admin.options.add_view	admin:sites_site_add
/admin/socialaccount/socialaccount/	django.contrib.admin.options.changelist_view	admin:socialaccount_socialaccount_changelist
/admin/socialaccount/socialaccount/<path:object_id>/	django.views.generic.base.RedirectView
/admin/socialaccount/socialaccount/<path:object_id>/change/	django.contrib.admin.options.change_view	admin:socialaccount_socialaccount_change
/admin/socialaccount/socialaccount/<path:object_id>/delete/	django.contrib.admin.options.delete_view	admin:socialaccount_socialaccount_delete
/admin/socialaccount/socialaccount/<path:object_id>/history/	django.contrib.admin.options.history_view	admin:socialaccount_socialaccount_history
/admin/socialaccount/socialaccount/add/	django.contrib.admin.options.add_view	admin:socialaccount_socialaccount_add
/admin/socialaccount/socialapp/	django.contrib.admin.options.changelist_view	admin:socialaccount_socialapp_changelist
/admin/socialaccount/socialapp/<path:object_id>/	django.views.generic.base.RedirectView
/admin/socialaccount/socialapp/<path:object_id>/change/	django.contrib.admin.options.change_view	admin:socialaccount_socialapp_change
/admin/socialaccount/socialapp/<path:object_id>/delete/	django.contrib.admin.options.delete_view	admin:socialaccount_socialapp_delete
/admin/socialaccount/socialapp/<path:object_id>/history/	django.contrib.admin.options.history_view	admin:socialaccount_socialapp_history
/admin/socialaccount/socialapp/add/	django.contrib.admin.options.add_view	admin:socialaccount_socialapp_add
/admin/socialaccount/socialtoken/	django.contrib.admin.options.changelist_view	admin:socialaccount_socialtoken_changelist
/admin/socialaccount/socialtoken/<path:object_id>/	django.views.generic.base.RedirectView
/admin/socialaccount/socialtoken/<path:object_id>/change/	django.contrib.admin.options.change_view	admin:socialaccount_socialtoken_change
/admin/socialaccount/socialtoken/<path:object_id>/delete/	django.contrib.admin.options.delete_view	admin:socialaccount_socialtoken_delete
/admin/socialaccount/socialtoken/<path:object_id>/history/	django.contrib.admin.options.history_view	admin:socialaccount_socialtoken_history
/admin/socialaccount/socialtoken/add/	django.contrib.admin.options.add_view	admin:socialaccount_socialtoken_add
/admin/taggit/tag/	django.contrib.admin.options.changelist_view	admin:taggit_tag_changelist
/admin/taggit/tag/<path:object_id>/	django.views.generic.base.RedirectView
/admin/taggit/tag/<path:object_id>/change/	django.contrib.admin.options.change_view	admin:taggit_tag_change
/admin/taggit/tag/<path:object_id>/delete/	django.contrib.admin.options.delete_view	admin:taggit_tag_delete
/admin/taggit/tag/<path:object_id>/history/	django.contrib.admin.options.history_view	admin:taggit_tag_history
/admin/taggit/tag/add/	django.contrib.admin.options.add_view	admin:taggit_tag_add
/admin/wagtaildocs/document/	django.contrib.admin.options.changelist_view	admin:wagtaildocs_document_changelist
/admin/wagtaildocs/document/<path:object_id>/	django.views.generic.base.RedirectView
/admin/wagtaildocs/document/<path:object_id>/change/	django.contrib.admin.options.change_view	admin:wagtaildocs_document_change
/admin/wagtaildocs/document/<path:object_id>/delete/	django.contrib.admin.options.delete_view	admin:wagtaildocs_document_delete
/admin/wagtaildocs/document/<path:object_id>/history/	django.contrib.admin.options.history_view	admin:wagtaildocs_document_history
/admin/wagtaildocs/document/add/	django.contrib.admin.options.add_view	admin:wagtaildocs_document_add
/admin/wagtailimages/image/	django.contrib.admin.options.changelist_view	admin:wagtailimages_image_changelist
/admin/wagtailimages/image/<path:object_id>/	django.views.generic.base.RedirectView
/admin/wagtailimages/image/<path:object_id>/change/	django.contrib.admin.options.change_view	admin:wagtailimages_image_change
/admin/wagtailimages/image/<path:object_id>/delete/	django.contrib.admin.options.delete_view	admin:wagtailimages_image_delete
/admin/wagtailimages/image/<path:object_id>/history/	django.contrib.admin.options.history_view	admin:wagtailimages_image_history
/admin/wagtailimages/image/add/	django.contrib.admin.options.add_view	admin:wagtailimages_image_add
/api/shell/	api.views.ShellEndpointView	shell-endpoint
/baton/app-list-json/	baton.views.GetAppListJsonView	baton-app-list-json
/baton/correct/	baton.views.CorrectView	baton-correct
/baton/generate-image/	baton.views.GenerateImageView	baton-generate-image
/baton/gravatar/	baton.views.GetGravatartUrlJsonView	baton-gravatar-json
/baton/summarize/	baton.views.SummarizeView	baton-summarize
/baton/translate/	baton.views.TranslateView	baton-translate
/baton/vision/	baton.views.VisionView	baton-vision
/billing/	apps.views.billing_view	app:billing
/book_flight/<str:flight>/	apps.views.book_flight	app:book_flight
/ckeditor/browse/	ckeditor_uploader.views.browse	ckeditor_browse
/ckeditor/upload/	ckeditor_uploader.views.ImageUploadView	ckeditor_upload
/cms/	wagtail.admin.views.home.HomeView	wagtailadmin_home
/cms/./	wagtail.admin.views.home.default
/cms/account/	wagtail.admin.views.account.AccountView	wagtailadmin_account
/cms/api/main/documents/	wagtail.documents.api.admin.views.DocumentsAdminAPIViewSet	wagtailadmin_api:documents:listing
/cms/api/main/documents/<int:pk>/	wagtail.documents.api.admin.views.DocumentsAdminAPIViewSet	wagtailadmin_api:documents:detail
/cms/api/main/documents/find/	wagtail.documents.api.admin.views.DocumentsAdminAPIViewSet	wagtailadmin_api:documents:find
/cms/api/main/images/	wagtail.images.api.admin.views.ImagesAdminAPIViewSet	wagtailadmin_api:images:listing
/cms/api/main/images/<int:pk>/	wagtail.images.api.admin.views.ImagesAdminAPIViewSet	wagtailadmin_api:images:detail
/cms/api/main/images/find/	wagtail.images.api.admin.views.ImagesAdminAPIViewSet	wagtailadmin_api:images:find
/cms/api/main/pages/	wagtail.admin.api.views.PagesAdminAPIViewSet	wagtailadmin_api:pages:listing
/cms/api/main/pages/<int:pk>/	wagtail.admin.api.views.PagesAdminAPIViewSet	wagtailadmin_api:pages:detail
/cms/api/main/pages/<int:pk>/action/<str:action_name>/	wagtail.admin.api.views.PagesAdminAPIViewSet	wagtailadmin_api:pages:action
/cms/api/main/pages/find/	wagtail.admin.api.views.PagesAdminAPIViewSet	wagtailadmin_api:pages:find
/cms/bulk/<str:app_label>/<str:model_name>/<str:action>/	wagtail.admin.views.bulk_action.dispatcher.index	wagtail_bulk_action
/cms/choose-anchor-link/	wagtail.admin.views.chooser.AnchorLinkView	wagtailadmin_choose_page_anchor_link
/cms/choose-email-link/	wagtail.admin.views.chooser.EmailLinkView	wagtailadmin_choose_page_email_link
/cms/choose-external-link/	wagtail.admin.views.chooser.ExternalLinkView	wagtailadmin_choose_page_external_link
/cms/choose-page/	wagtail.admin.views.chooser.BrowseView	wagtailadmin_choose_page
/cms/choose-page/<int:parent_page_id>/	wagtail.admin.views.chooser.BrowseView	wagtailadmin_choose_page_child
/cms/choose-page/chosen-multiple/	wagtail.admin.views.chooser.ChosenMultipleView	wagtailadmin_choose_page_chosen_multiple
/cms/choose-page/search/	wagtail.admin.views.chooser.SearchView	wagtailadmin_choose_page_search
/cms/choose-phone-link/	wagtail.admin.views.chooser.PhoneLinkView	wagtailadmin_choose_page_phone_link
/cms/collections/	wagtail.admin.views.collections.Index	wagtailadmin_collections:index
/cms/collections/<int:collection_id>/privacy/	wagtail.admin.views.collection_privacy.set_privacy	wagtailadmin_collections:set_privacy
/cms/collections/<int:pk>/	wagtail.admin.views.collections.Edit	wagtailadmin_collections:edit
/cms/collections/<int:pk>/delete/	wagtail.admin.views.collections.Delete	wagtailadmin_collections:delete
/cms/collections/add/	wagtail.admin.views.collections.Create	wagtailadmin_collections:add
/cms/dismissibles/	wagtail.admin.views.dismissibles.DismissiblesView	wagtailadmin_dismissibles
/cms/documents/	wagtail.documents.views.documents.IndexView	wagtaildocs:index
/cms/documents/add/	wagtail.documents.views.documents.add	wagtaildocs:add
/cms/documents/chooser/	wagtail.documents.views.chooser.DocumentChooseView	wagtaildocs_chooser:choose
/cms/documents/chooser/chosen-multiple/	wagtail.admin.views.generic.chooser.ChosenMultipleView	wagtaildocs_chooser:chosen_multiple
/cms/documents/chooser/chosen/<str:pk>/	wagtail.documents.views.chooser.DocumentChosenView	wagtaildocs_chooser:chosen
/cms/documents/chooser/create/	wagtail.documents.views.chooser.DocumentChooserUploadView	wagtaildocs_chooser:create
/cms/documents/chooser/results/	wagtail.documents.views.chooser.DocumentChooseResultsView	wagtaildocs_chooser:choose_results
/cms/documents/delete/<int:document_id>/	wagtail.documents.views.documents.DeleteView	wagtaildocs:delete
/cms/documents/edit/<int:document_id>/	wagtail.documents.views.documents.edit	wagtaildocs:edit
/cms/documents/multiple/<int:doc_id>/	wagtail.documents.views.multiple.EditView	wagtaildocs:edit_multiple
/cms/documents/multiple/<int:doc_id>/delete/	wagtail.documents.views.multiple.DeleteView	wagtaildocs:delete_multiple
/cms/documents/multiple/add/	wagtail.documents.views.multiple.AddView	wagtaildocs:add_multiple
/cms/documents/multiple/create_from_uploaded_document/<int:uploaded_file_id>/	wagtail.documents.views.multiple.CreateFromUploadedDocumentView	wagtaildocs:create_multiple_from_uploaded_document
/cms/documents/multiple/delete_upload/<int:uploaded_file_id>/	wagtail.documents.views.multiple.DeleteUploadView	wagtaildocs:delete_upload_multiple
/cms/documents/results/	wagtail.documents.views.documents.IndexView	wagtaildocs:index_results
/cms/documents/usage/<int:document_id>/	wagtail.documents.views.documents.UsageView	wagtaildocs:document_usage
/cms/editing-sessions/ping/<str:app_label>/<str:model_name>/<str:object_id>/<int:session_id>/	wagtail.admin.views.editing_sessions.ping	wagtailadmin_editing_sessions:ping
/cms/editing-sessions/release/<int:session_id>/	wagtail.admin.views.editing_sessions.release	wagtailadmin_editing_sessions:release
/cms/embeds/chooser/	wagtail.embeds.views.chooser.chooser	wagtailembeds:chooser
/cms/embeds/chooser/upload/	wagtail.embeds.views.chooser.chooser_upload	wagtailembeds:chooser_upload
/cms/failwhale/	wagtail.admin.views.home.error_test	wagtailadmin_error_test
/cms/forms/	wagtail.contrib.forms.views.FormPagesListView	wagtailforms:index
/cms/forms/results/	wagtail.contrib.forms.views.FormPagesListView	wagtailforms:index_results
/cms/forms/submissions/<int:page_id>/	wagtail.contrib.forms.views.get_submissions_list_view	wagtailforms:list_submissions
/cms/forms/submissions/<int:page_id>/delete/	wagtail.contrib.forms.views.DeleteSubmissionsView	wagtailforms:delete_submissions
/cms/forms/submissions/<int:page_id>/results/	wagtail.contrib.forms.views.get_submissions_list_view	wagtailforms:list_submissions_results
/cms/groups/	wagtail.users.views.groups.IndexView	wagtailusers_groups:index
/cms/groups/<str:pk>/	wagtail.admin.viewsets.model.redirect_to_edit
/cms/groups/<str:pk>/delete/	wagtail.admin.viewsets.model.redirect_to_delete
/cms/groups/<var>/users/	wagtail.users.views.groups.view	wagtailusers_groups:users
/cms/groups/copy/<str:pk>/	wagtail.admin.views.generic.models.CopyView	wagtailusers_groups:copy
/cms/groups/delete/<str:pk>/	wagtail.users.views.groups.DeleteView	wagtailusers_groups:delete
/cms/groups/edit/<str:pk>/	wagtail.users.views.groups.EditView	wagtailusers_groups:edit
/cms/groups/history-results/<str:pk>/	wagtail.admin.views.generic.history.HistoryView	wagtailusers_groups:history_results
/cms/groups/history/<str:pk>/	wagtail.admin.views.generic.history.HistoryView	wagtailusers_groups:history
/cms/groups/new/	wagtail.users.views.groups.CreateView	wagtailusers_groups:add
/cms/groups/results/	wagtail.users.views.groups.IndexView	wagtailusers_groups:index_results
/cms/groups/usage/<str:pk>/	wagtail.admin.views.generic.usage.UsageView	wagtailusers_groups:usage
/cms/images/	wagtail.images.views.images.IndexView	wagtailimages:index
/cms/images/<int:image_id>/	wagtail.images.views.images.edit	wagtailimages:edit
/cms/images/<int:image_id>/delete/	wagtail.images.views.images.DeleteView	wagtailimages:delete
/cms/images/<int:image_id>/generate_url/	wagtail.images.views.images.URLGeneratorView	wagtailimages:url_generator
/cms/images/<int:image_id>/generate_url/<str:filter_spec>/	wagtail.images.views.images.GenerateURLView	wagtailimages:generate_url
/cms/images/<int:image_id>/preview/<str:filter_spec>/	wagtail.images.views.images.preview	wagtailimages:preview
/cms/images/add/	wagtail.images.views.images.add	wagtailimages:add
/cms/images/chooser/	wagtail.images.views.chooser.ImageChooseView	wagtailimages_chooser:choose
/cms/images/chooser/<int:image_id>/select_format/	wagtail.images.views.chooser.ImageSelectFormatView	wagtailimages_chooser:select_format
/cms/images/chooser/chosen-multiple/	wagtail.images.views.chooser.ImageChosenMultipleView	wagtailimages_chooser:chosen_multiple
/cms/images/chooser/chosen/<str:pk>/	wagtail.images.views.chooser.ImageChosenView	wagtailimages_chooser:chosen
/cms/images/chooser/create/	wagtail.images.views.chooser.ImageUploadView	wagtailimages_chooser:create
/cms/images/chooser/results/	wagtail.images.views.chooser.ImageChooseResultsView	wagtailimages_chooser:choose_results
/cms/images/multiple/<int:image_id>/	wagtail.images.views.multiple.EditView	wagtailimages:edit_multiple
/cms/images/multiple/<int:image_id>/delete/	wagtail.images.views.multiple.DeleteView	wagtailimages:delete_multiple
/cms/images/multiple/add/	wagtail.images.views.multiple.AddView	wagtailimages:add_multiple
/cms/images/multiple/create_from_uploaded_image/<int:uploaded_file_id>/	wagtail.images.views.multiple.CreateFromUploadedImageView	wagtailimages:create_multiple_from_uploaded_image
/cms/images/multiple/delete_upload/<int:uploaded_file_id>/	wagtail.images.views.multiple.DeleteUploadView	wagtailimages:delete_upload_multiple
/cms/images/results/	wagtail.images.views.images.IndexView	wagtailimages:index_results
/cms/images/usage/<int:image_id>/	wagtail.images.views.images.UsageView	wagtailimages:image_usage
/cms/jsi18n/	django.views.i18n.JavaScriptCatalog	wagtailadmin_javascript_catalog
/cms/login/	wagtail.admin.views.account.LoginView	wagtailadmin_login
/cms/logout/	wagtail.admin.views.account.LogoutView	wagtailadmin_logout
/cms/pages/	wagtail.admin.views.pages.listing.ExplorableIndexView	wagtailadmin_explore_root
/cms/pages/<int:page_id>/convert_alias/	wagtail.admin.views.pages.convert_alias.convert_alias	wagtailadmin_pages:convert_alias
/cms/pages/<int:page_id>/copy/	wagtail.admin.views.pages.copy.copy	wagtailadmin_pages:copy
/cms/pages/<int:page_id>/delete/	wagtail.admin.views.pages.delete.delete	wagtailadmin_pages:delete
/cms/pages/<int:page_id>/edit/	wagtail.admin.views.pages.edit.EditView	wagtailadmin_pages:edit
/cms/pages/<int:page_id>/edit/preview/	wagtail.admin.views.pages.preview.PreviewOnEdit	wagtailadmin_pages:preview_on_edit
/cms/pages/<int:page_id>/history/	wagtail.admin.views.pages.history.PageHistoryView	wagtailadmin_pages:history
/cms/pages/<int:page_id>/history/results/	wagtail.admin.views.pages.history.PageHistoryView	wagtailadmin_pages:history_results
/cms/pages/<int:page_id>/lock/	wagtail.admin.views.pages.lock.LockView	wagtailadmin_pages:lock
/cms/pages/<int:page_id>/privacy/	wagtail.admin.views.page_privacy.set_privacy	wagtailadmin_pages:set_privacy
/cms/pages/<int:page_id>/revisions/	wagtail.admin.views.pages.revisions.revisions_index	wagtailadmin_pages:revisions_index
/cms/pages/<int:page_id>/revisions/<int:revision_id>/revert/	wagtail.admin.views.pages.revisions.revisions_revert	wagtailadmin_pages:revisions_revert
/cms/pages/<int:page_id>/revisions/<int:revision_id>/unschedule/	wagtail.admin.views.pages.revisions.RevisionsUnschedule	wagtailadmin_pages:revisions_unschedule
/cms/pages/<int:page_id>/revisions/<int:revision_id>/view/	wagtail.admin.views.pages.revisions.RevisionsView	wagtailadmin_pages:revisions_view
/cms/pages/<int:page_id>/unlock/	wagtail.admin.views.pages.lock.UnlockView	wagtailadmin_pages:unlock
/cms/pages/<int:page_id>/unpublish/	wagtail.admin.views.pages.unpublish.Unpublish	wagtailadmin_pages:unpublish
/cms/pages/<int:page_id>/usage/	wagtail.admin.views.pages.usage.UsageView	wagtailadmin_pages:usage
/cms/pages/<int:page_id>/view_draft/	wagtail.admin.views.pages.preview.view_draft	wagtailadmin_pages:view_draft
/cms/pages/<int:page_id>/workflow_history/	wagtail.admin.views.pages.history.WorkflowHistoryView	wagtailadmin_pages:workflow_history
/cms/pages/<int:page_id>/workflow_history/detail/<int:workflow_state_id>/	wagtail.admin.views.pages.history.WorkflowHistoryDetailView	wagtailadmin_pages:workflow_history_detail
/cms/pages/<int:page_to_move_id>/move/	wagtail.admin.views.pages.move.move_choose_destination	wagtailadmin_pages:move
/cms/pages/<int:page_to_move_id>/move/<int:destination_id>/confirm/	wagtail.admin.views.pages.move.move_confirm	wagtailadmin_pages:move_confirm
/cms/pages/<int:page_to_move_id>/set_position/	wagtail.admin.views.pages.ordering.set_page_position	wagtailadmin_pages:set_page_position
/cms/pages/<int:parent_page_id>/	wagtail.admin.views.pages.listing.ExplorableIndexView	wagtailadmin_explore
/cms/pages/<int:parent_page_id>/add_subpage/	wagtail.admin.views.pages.create.add_subpage	wagtailadmin_pages:add_subpage
/cms/pages/<int:parent_page_id>/results/	wagtail.admin.views.pages.listing.ExplorableIndexView	wagtailadmin_explore_results
/cms/pages/<var>/revisions/compare/cms/pages/(\d)/revisions/compare/<var>\.\.\.cms/pages/(\d)/revisions/compare/(live|earliest|\d)\.\.\.<var>/	wagtail.admin.views.pages.revisions.RevisionsCompare	wagtailadmin_pages:revisions_compare
/cms/pages/add/<slug:content_type_app_name>/<slug:content_type_model_name>/<int:parent_page_id>/	wagtail.admin.views.pages.create.CreateView	wagtailadmin_pages:add
/cms/pages/add/<slug:content_type_app_name>/<slug:content_type_model_name>/<int:parent_page_id>/preview/	wagtail.admin.views.pages.preview.PreviewOnCreate	wagtailadmin_pages:preview_on_add
/cms/pages/search/	wagtail.admin.views.pages.search.SearchView	wagtailadmin_pages:search
/cms/pages/search/results/	wagtail.admin.views.pages.search.SearchResultsView	wagtailadmin_pages:search_results
/cms/pages/usage/<slug:content_type_app_name>/<slug:content_type_model_name>/	wagtail.admin.views.pages.usage.ContentTypeUseView	wagtailadmin_pages:type_use
/cms/pages/workflow/action/<int:page_id>/<slug:action_name>/<int:task_state_id>/	wagtail.admin.views.pages.workflow.WorkflowAction	wagtailadmin_pages:workflow_action
/cms/pages/workflow/collect_action_data/<int:page_id>/<slug:action_name>/<int:task_state_id>/	wagtail.admin.views.pages.workflow.CollectWorkflowActionData	wagtailadmin_pages:collect_workflow_action_data
/cms/pages/workflow/confirm_cancellation/<int:page_id>/	wagtail.admin.views.pages.workflow.ConfirmWorkflowCancellation	wagtailadmin_pages:confirm_workflow_cancellation
/cms/pages/workflow/preview/<int:page_id>/<int:task_id>/	wagtail.admin.views.pages.workflow.PreviewRevisionForTask	wagtailadmin_pages:workflow_preview
/cms/password_reset/	wagtail.admin.views.account.PasswordResetView	wagtailadmin_password_reset
/cms/password_reset/complete/	wagtail.admin.views.account.PasswordResetCompleteView	wagtailadmin_password_reset_complete
/cms/password_reset/confirm/<uidb64>/<token>/	wagtail.admin.views.account.PasswordResetConfirmView	wagtailadmin_password_reset_confirm
/cms/password_reset/done/	wagtail.admin.views.account.PasswordResetDoneView	wagtailadmin_password_reset_done
/cms/redirects/	wagtail.contrib.redirects.views.IndexView	wagtailredirects:index
/cms/redirects/<int:redirect_id>/	wagtail.contrib.redirects.views.EditView	wagtailredirects:edit
/cms/redirects/<int:redirect_id>/delete/	wagtail.contrib.redirects.views.delete	wagtailredirects:delete
/cms/redirects/add/	wagtail.contrib.redirects.views.add	wagtailredirects:add
/cms/redirects/import/	wagtail.contrib.redirects.views.start_import	wagtailredirects:start_import
/cms/redirects/import/process/	wagtail.contrib.redirects.views.process_import	wagtailredirects:process_import
/cms/redirects/results/	wagtail.contrib.redirects.views.IndexView	wagtailredirects:index_results
/cms/reports/aging-pages/	wagtail.admin.views.reports.aging_pages.AgingPagesView	wagtailadmin_reports:aging_pages
/cms/reports/aging-pages/results/	wagtail.admin.views.reports.aging_pages.AgingPagesView	wagtailadmin_reports:aging_pages_results
/cms/reports/locked/	wagtail.admin.views.reports.locked_pages.LockedPagesView	wagtailadmin_reports:locked_pages
/cms/reports/locked/results/	wagtail.admin.views.reports.locked_pages.LockedPagesView	wagtailadmin_reports:locked_pages_results
/cms/reports/page-types-usage/	wagtail.admin.views.reports.page_types_usage.PageTypesUsageReportView	wagtailadmin_reports:page_types_usage
/cms/reports/page-types-usage/results/	wagtail.admin.views.reports.page_types_usage.PageTypesUsageReportView	wagtailadmin_reports:page_types_usage_results
/cms/reports/site-history/	wagtail.admin.views.reports.audit_logging.LogEntriesView	wagtailadmin_reports:site_history
/cms/reports/site-history/results/	wagtail.admin.views.reports.audit_logging.LogEntriesView	wagtailadmin_reports:site_history_results
/cms/reports/workflow/	wagtail.admin.views.reports.workflows.WorkflowView	wagtailadmin_reports:workflow
/cms/reports/workflow/results/	wagtail.admin.views.reports.workflows.WorkflowView	wagtailadmin_reports:workflow_results
/cms/reports/workflow_tasks/	wagtail.admin.views.reports.workflows.WorkflowTasksView	wagtailadmin_reports:workflow_tasks
/cms/reports/workflow_tasks/results/	wagtail.admin.views.reports.workflows.WorkflowTasksView	wagtailadmin_reports:workflow_tasks_results
/cms/sites/	wagtail.sites.views.IndexView	wagtailsites:index
/cms/sites/<str:pk>/	wagtail.admin.viewsets.model.redirect_to_edit
/cms/sites/<str:pk>/delete/	wagtail.admin.viewsets.model.redirect_to_delete
/cms/sites/copy/<str:pk>/	wagtail.admin.views.generic.models.CopyView	wagtailsites:copy
/cms/sites/delete/<str:pk>/	wagtail.sites.views.DeleteView	wagtailsites:delete
/cms/sites/edit/<str:pk>/	wagtail.sites.views.EditView	wagtailsites:edit
/cms/sites/history-results/<str:pk>/	wagtail.admin.views.generic.history.HistoryView	wagtailsites:history_results
/cms/sites/history/<str:pk>/	wagtail.admin.views.generic.history.HistoryView	wagtailsites:history
/cms/sites/new/	wagtail.sites.views.CreateView	wagtailsites:add
/cms/sites/results/	wagtail.sites.views.IndexView	wagtailsites:index_results
/cms/sites/usage/<str:pk>/	wagtail.admin.views.generic.usage.UsageView	wagtailsites:usage
/cms/snippets/	wagtail.snippets.views.snippets.ModelIndexView	wagtailsnippets:index
/cms/sprite/	wagtail.admin.views.home.sprite	wagtailadmin_sprite
/cms/tag-autocomplete/	wagtail.admin.views.tags.autocomplete	wagtailadmin_tag_autocomplete
/cms/tag-autocomplete/<slug:app_name>/<slug:model_name>/	wagtail.admin.views.tags.autocomplete	wagtailadmin_tag_model_autocomplete
/cms/test404/	django.views.generic.base.TemplateView
/cms/users/	wagtail.users.views.users.IndexView	wagtailusers_users:index
/cms/users/<str:pk>/	wagtail.admin.viewsets.model.redirect_to_edit
/cms/users/<str:pk>/delete/	wagtail.admin.viewsets.model.redirect_to_delete
/cms/users/copy/<str:pk>/	wagtail.admin.views.generic.models.CopyView	wagtailusers_users:copy
/cms/users/delete/<str:pk>/	wagtail.users.views.users.DeleteView	wagtailusers_users:delete
/cms/users/edit/<str:pk>/	wagtail.users.views.users.EditView	wagtailusers_users:edit
/cms/users/history-results/<str:pk>/	wagtail.users.views.users.HistoryView	wagtailusers_users:history_results
/cms/users/history/<str:pk>/	wagtail.users.views.users.HistoryView	wagtailusers_users:history
/cms/users/new/	wagtail.users.views.users.CreateView	wagtailusers_users:add
/cms/users/results/	wagtail.users.views.users.IndexView	wagtailusers_users:index_results
/cms/users/usage/<str:pk>/	wagtail.admin.views.generic.usage.UsageView	wagtailusers_users:usage
/cms/workflows/add/	wagtail.admin.views.workflows.Create	wagtailadmin_workflows:add
/cms/workflows/disable/<int:pk>/	wagtail.admin.views.workflows.Disable	wagtailadmin_workflows:disable
/cms/workflows/edit/<int:pk>/	wagtail.admin.views.workflows.Edit	wagtailadmin_workflows:edit
/cms/workflows/enable/<int:pk>/	wagtail.admin.views.workflows.enable_workflow	wagtailadmin_workflows:enable
/cms/workflows/list/	wagtail.admin.views.workflows.Index	wagtailadmin_workflows:index
/cms/workflows/list/results/	wagtail.admin.views.workflows.Index	wagtailadmin_workflows:index_results
/cms/workflows/remove/<int:page_pk>/	wagtail.admin.views.workflows.remove_workflow	wagtailadmin_workflows:remove
/cms/workflows/remove/<int:page_pk>/<int:workflow_pk>/	wagtail.admin.views.workflows.remove_workflow	wagtailadmin_workflows:remove
/cms/workflows/task_chooser/	wagtail.admin.views.workflows.TaskChooserView	wagtailadmin_workflows:task_chooser
/cms/workflows/task_chooser/<int:task_id>/	wagtail.admin.views.workflows.task_chosen	wagtailadmin_workflows:task_chosen
/cms/workflows/task_chooser/create/	wagtail.admin.views.workflows.TaskChooserCreateView	wagtailadmin_workflows:task_chooser_create
/cms/workflows/task_chooser/results/	wagtail.admin.views.workflows.TaskChooserResultsView	wagtailadmin_workflows:task_chooser_results
/cms/workflows/tasks/add/<str:app_label>/<str:model_name>/	wagtail.admin.views.workflows.CreateTask	wagtailadmin_workflows:add_task
/cms/workflows/tasks/disable/<int:pk>/	wagtail.admin.views.workflows.DisableTask	wagtailadmin_workflows:disable_task
/cms/workflows/tasks/edit/<int:pk>/	wagtail.admin.views.workflows.EditTask	wagtailadmin_workflows:edit_task
/cms/workflows/tasks/enable/<int:pk>/	wagtail.admin.views.workflows.enable_task	wagtailadmin_workflows:enable_task
/cms/workflows/tasks/index/	wagtail.admin.views.workflows.TaskIndex	wagtailadmin_workflows:task_index
/cms/workflows/tasks/index/results/	wagtail.admin.views.workflows.TaskIndex	wagtailadmin_workflows:task_index_results
/cms/workflows/tasks/select_type/	wagtail.admin.views.workflows.select_task_type	wagtailadmin_workflows:select_task_type
/cms/workflows/usage/<int:pk>/	wagtail.admin.views.workflows.usage	wagtailadmin_workflows:usage
/dashboard/	apps.views.dashboard_view	app:dashboard
/dataviz/	apps.dataviz.comprehensive_dashboard	app:comprehensive_dashboard
/delete_appointment/<int:id>/	apps.views.delete_appointment	app:delete_appointment
/delete_prescription/<int:id>/	apps.views.delete_prescription	app:delete_prescription
/destination_airport_search/	apps.views.destination_airport_search	app:destination_airport_search
/documents/<var>/documents/(\d)/<var>	wagtail.documents.views.serve.serve	wagtaildocs_serve
/documents/authenticate_with_password/<int:restriction_id>/	wagtail.documents.views.serve.authenticate_with_password	wagtaildocs_authenticate_with_password
/edit_appointment/<int:id>/	apps.views.appointment_form	app:edit_appointment
/edit_prescription/<int:id>/	apps.views.prescription_form	app:edit_prescription
/editor/	editor.views.editor_view	editor
/flight/	apps.views.demo	app:demo
/generate-referral-code/	apps.views.generate_referral_code_view	app:generate_referral_code_view
/get_currency_code/	apps.views.get_currency_code_ajax	app:get_currency_code
/leads/	leads.views.lead_list	leads:lead_list
/leads/add-note/<int:lead_id>/	leads.views.add_note	leads:add_note
/leads/api/generate-invoice/	leads.views.GenerateInvoiceView	leads:generate-invoice
/leads/calendar-events/	leads.views.get_lead_events	leads:calendar_events
/leads/edit-lead/<int:pk>/	leads.views.edit_lead	leads:edit_lead
/leads/lead-history/<int:lead_id>/	leads.views.get_lead_history	leads:lead_history
/leads/log-whatsapp-action/<int:lead_id>/	leads.views.log_whatsapp_action	leads:log_whatsapp_action
/leads/send-email/<int:lead_id>/	leads.views.send_email	leads:send_email
/leads/upload-csv/	leads.views.upload_csv	leads:upload_csv
/login/	apps.views.login_view	app:login
/logout/	apps.views.logout_view	app:logout
/logs/	apps.views.logs	app:logs
/map/	apps.views.map_view	app:map
/marketing/	apps.views.marketing_view	app:marketing
/media/<path>	django.views.static.serve
/media/<path>	django.views.static.serve
/messages/	apps.views.messages	app:messages
/messages/<int:id>/	apps.views.conversation	app:conversation
/microsofter/	apps.views.microsofter	app:microsofter
/my-treatment-plans/	apps.mew.my_treatment_plans	app:my_treatment_plans
/my-treatment-plans/download/	apps.mew.download_treatment_plan_pdf	app:download_treatment_plan_pdf
/ndash/	apps.mew.ndashboard_view	app:ndash
/ocr_uploaded_document/	apps.views.ocr_uploaded_document	app:ocr_uploaded_document
/origin_airport_search/	apps.views.origin_airport_search	app:origin_airport_search
/patients/	apps.mew.list_patients	app:list_patients
/patients/<int:patient_id>/	apps.mew.patient_detail	app:patient_detail
/patients/<int:patient_id>/treatment-plan/new/	apps.TreatmentPlanview.create_treatment_plan	app:create_treatment_plan
/prescriptions/	apps.views.prescriptions	app:prescriptions
/prescriptions_invoice/	apps.views.prescriptions_invoice_view	app:prescriptions_invoice_view
/preview-error/	apps.errors.preview_error	app:preview_error
/privacypolicy/	apps.views.privacypolicy	app:privacypolicy
/product/	apps.views.product_list	app:product
/profile/	apps.views.profile	app:profile
/project/	apps.views.project	app:project
/redoc/	drf_yasg.views.SchemaView	schema-redoc
/reverse_geocode/	apps.views.reverse_geocode	app:reverse_geocode
/rosetta/	django.views.generic.base.RedirectView	rosetta-old-home-redirect
/rosetta/files/	django.views.generic.base.RedirectView	rosetta-file-list-redirect
/rosetta/files/<po_filter>/	rosetta.views.TranslationFileListView	rosetta-file-list
/rosetta/files/<po_filter>/<lang_id>/<idx>/	rosetta.views.TranslationFormView	rosetta-form
/rosetta/files/<po_filter>/<lang_id>/<idx>/download/	rosetta.views.TranslationFileDownload	rosetta-download-file
/rosetta/translate/	rosetta.views.translate_text	rosetta.translate_text
/salesdash/	apps.views.salesdash	app:salesdash
/schedule/	apps.views.scheduletemp	app:schedule
/serp/	apps.views.serp_view	app:serp
/set_language/	apps.views.set_language	app:set_language
/signup/	apps.views.signup	app:signup
/static/<path>	django.views.static.serve
/streamlit_embed/	apps.views.streamlit_embed	app:streamlit_embed
/swagger/	drf_yasg.views.SchemaView	schema-swagger-ui
/topblogs/	topblogs.views.tbindex_view	topblogs:tbindex
/topblogs/dashboard/	topblogs.views.dashboard_view	topblogs:dashboard
/topblogs/estetik/	topblogs.views.estetik_view	topblogs:estetik
/topblogs/ht/	topblogs.views.ht_view	topblogs:ht
/topblogs/internalsurgeries/	topblogs.views.internal_surgeries_view	topblogs:internal_surgeries
/topblogs/set_language/	topblogs.views.set_language	topblogs:set_language
/topblogs/whybeyond/	topblogs.views.whybeyond_view	topblogs:whybeyond
/topblogs/whyturkey/	topblogs.views.whyturkey_view	topblogs:whyturkey
/transfers/	apps.views.transfers	app:transfers
/treatment-plan/<int:treatment_plan_id>/	apps.TreatmentPlanview.TreatmentPlanDetailView	app:treatment_plan_detail
/treatment-plan/<int:treatment_plan_id>/edit/	apps.TreatmentPlanview.edit_treatment_plan	app:edit_treatment_plan
/upload_id_and_save/	apps.views.upload_id_and_save	app:upload_id_and_save
/user-table/	apps.views.user_list_view	app:user_table
/users/	apps.views.users	app:users
/users/<int:id>/	apps.views.medical_information	app:medical_information
/users/<int:id>/info.json/	apps.views.export	app:export
/users/me/	apps.views.my_medical_information	app:my_medical_information
/users/me/info.json/	apps.views.export_me	app:export_me
/virtual-reality/	apps.views.virtual_reality	app:virtual-reality
/wag/<var>	wagtail.views.serve	wagtail_serve
/wag/_util/authenticate_with_password/<int:page_view_restriction_id>/<int:page_id>/	wagtail.views.authenticate_with_password	wagtailcore_authenticate_with_password
/wag/_util/login/	django.contrib.auth.views.LoginView	wagtailcore_login
/website	django.views.generic.base.RedirectView	websites:home
/websiteHT/	websites.views.HT_view	websites:HT
/websiteabout/	websites.views.about_view	websites:about
/websiteblog/	websites.views.blog_view	websites:blog
/websitecomingsoon/	websites.views.comingsoon_view	websites:comingsoon
/websitedashboard/	websites.views.dashboard_view	websites:dashboard
/websitedentaslan/	websites.views.dentaslan_view	websites:dentaslan
/websitedentaslanFR/	websites.views.dentaslanFR_view	websites:dentaslanFR
/websiteestetik/	websites.views.estetik_view	websites:estetik
/websitegrid/	websites.views.grid_view	websites:grid
/websiteinnovation/	websites.views.innovation_view	websites:innovation
/websitemasonry/	websites.views.masonry_view	websites:masonry
/websitemedia/<path>	django.views.static.serve
/websiteset_language/	websites.views.set_language	websites:set_language
/websitesingle-post/	websites.views.single_post_view	websites:single-post
/websitetooth-model/	websites.views.tooth_model_view	websites:tooth_model
/websitewhybeyond/	websites.views.whybeyond_view	websites:whybeyond
/websitewhyturkey/	websites.views.whyturkey_view	websites:whyturkey
/welcome/	apps.views.welcome_view	app:welcome_view
